1111111111111
1P00000000001
11100010101E1
10000C0010001
1000001010101
1111111111111
