1111111111111
1P00000000001
1110001010101
10000C00000E1
1000001010101
1111111111111
