1111111111111
1E0000P000101
1C01001C10101
1001001010101
100C00101C001
1111111111111
