1111111111111
1C000000C0001
1C000011C1001
1000010100101
100001E1000P1
1111111111111
