1111111111
1000000C01
1011110101
1P1CCC01E1
1111111111
