1111111111111111111111111111111111
1P00000000C00000000000000000000001
1010010100100C00101001000000010101
1010010C10101E10C01001000000010101
10C00C010000000000C0010000010C0C01
10001000010C100001000C000010000001
1001C1000C01C0100C00100001C0000001
10000000010000010001C0000100000001
1000000100000000000001000001000001
1000100C010C100001000C000010010101
1001C1000C01C01C0C00100001C00C1C01
10000000010000010001C00001000C1C01
1111111111111111111111111111111111