1111111111111
1C100000C1001
1110010101001
100001E1000P1
1111111111111
