1111111111111
1C000000C1001
1000011100101
100001E0000P1
1111111111111
