1111111111111111111111111111111111
1E1000000000100C10000C000000000001
1010010100101010101001000P00010101
1010010010101010101001000000010101
1C0000000C00C0100000010000000100C1
1111111111111111111111111111111111